;***************************************************************************************************
;        ARQUIVO DE MAPEAMENTO PARA O PADRÃO D2TI
;***************************************************************************************************

;***************************************************************************************************
;Configuração do NFSeDataset para Envio de Lote de RPS (Proxy)
;***************************************************************************************************
[ENVIAR]
XSDElementName=nfseLote
XSDFile=RecepcaoNFSe_v1.00.xsd
XSDStartNode=
IgnoredXPaths=
UseNamespacePrefixes=0
XMLHeader=
RootAttributes=

;***************************************************************************************************
;Nomes dos comandos para os respectivos datasets (para uso nos arquivos TX2)
;***************************************************************************************************
[comandos]
nfseLote.Insert=INCLUIR
nfseLote.Post=SALVAR
itemMapa.Insert=INCLUIRITEMMAPA
itemMapa.Post=SALVARITEMMAPA
item.Insert=INCLUIRITEM
item.Post=SALVARITEM
imposto.Insert=INCLUIRIMPOSTO
imposto.Post=SALVARIMPOSTO

;***************************************************************************************************
;Nomes dos Campos: Envio de Lote de RPS (Proxy)
;***************************************************************************************************
[nfseLote]
codigoMunicipio=nfseLote/codigoMunicipio
dtEmissao=nfseLote/dtEmissao
notaIntermediada=nfseLote/notaIntermediada
token=nfseLote/autenticacao/token
tipoPessoaPrestador=nfseLote/prestador/tipoPessoa
CpfPrestador=nfseLote/prestador/cpf
CnpjPrestador=nfseLote/prestador/cnpj
inscricaoMunicipalPrestador=nfseLote/prestador/inscricaoMunicipal
razaoSocialPrestador=nfseLote/prestador/razaoSocial
EnderecoPrestador=nfseLote/prestador/endereco/logradouro
complementoPrestador=nfseLote/prestador/endereco/complemento
bairroPrestador=nfseLote/prestador/endereco/bairro
cepPrestador=nfseLote/prestador/endereco/cep
codigoCidadePrestador=nfseLote/prestador/endereco/codigoMunipio
descricaoMunicipioPrestador=nfseLote/prestador/endereco/descricaoMunicipio
codigoEstadoPrestador=nfseLote/prestador/endereco/codigoEstado
descricaoEstadoPrestador=nfseLote/prestador/endereco/descricaoEstado
emailPrestador=nfseLote/prestador/email
DDDPrestador=nfseLote/prestador/telefoneDdd
TelefonePrestador=nfseLote/prestador/telefoneNumero
tomadorIdentificado=nfseLote/tomador/tomadorIdentificado
tipoPessoaTomador=nfseLote/tomador/tipoPessoa
cpfTomador=nfseLote/tomador/cpf
cnpjTomador=nfseLote/tomador/cnpj
inscricaoMunicipalTomador=nfseLote/tomador/inscricaoMunicipal
razaoSocialTomador=nfseLote/tomador/razaoSocial
exterior=nfseLote/tomador/exterior
EnderecoTomador=nfseLote/tomador/endereco/logradouro
complementoTomador=nfseLote/tomador/endereco/complemento
bairroTomador=nfseLote/tomador/endereco/bairro
cepTomador=nfseLote/tomador/endereco/cep
codigoCidadeTomador=nfseLote/tomador/endereco/codigoMunipio
descricaoMunicipioTomador=nfseLote/tomador/endereco/descricaoMunicipio
codigoEstadoTomador=nfseLote/tomador/endereco/codigoEstado
descricaoEstadoTomador=nfseLote/tomador/endereco/descricaoEstado
emailTomador=nfseLote/tomador/email
DDDTomador=nfseLote/tomador/telefoneDdd
telefoneTomador=nfseLote/tomador/telefoneNumero
apelido=nfseLote/tomador/apelido
tipoPessoaIntermediario=nfseLote/intermediador/tipoPessoa
cpfIntermediario=nfseLote/intermediador/cpf
cnpjIntermediario=nfseLote/intermediador/cnpj
inscricaoMunicipalIntermediario=nfseLote/intermediador/inscricaoMunicipal
razaoSocialIntermediario=nfseLote/intermediador/razaoSocial
logradouroIntermediario=nfseLote/intermediador/endereco/logradouro
complementoIntermediario=nfseLote/intermediador/endereco/complemento
bairroIntermediario=nfseLote/intermediador/endereco/bairro
cepIntermediario=nfseLote/intermediador/endereco/cep
codigoMunipioIntermediario=nfseLote/intermediador/endereco/codigoMunipio
descricaoMunicipioIntermediario=nfseLote/intermediador/endereco/descricaoMunicipio
codigoEstadoIntermediario=nfseLote/intermediador/endereco/codigoEstado
descricaoEstadoIntermediario=nfseLote/intermediador/endereco/descricaoEstado
emailIntermediario=nfseLote/intermediador/email
telefoneDddIntermediario=nfseLote/intermediador/telefoneDdd
telefoneNumeroIntermediario=nfseLote/intermediador/telefoneNumero
codigoServico=nfseLote/atividadeExecutada/codigoServico
descricaoServico=nfseLote/atividadeExecutada/descricaoServico
codigoAtividade=nfseLote/atividadeExecutada/codigoAtividade
descricaoAtividade=nfseLote/atividadeExecutada/descricaoAtividade
codigoEstadoPrestacao=nfseLote/atividadeExecutada/localPrestacao/codigoEstado
descricaoEstadoPrestacao=nfseLote/atividadeExecutada/localPrestacao/descricaoEstado
codigoCidadePrestacao=nfseLote/atividadeExecutada/localPrestacao/codigoMunipio
descricaoMunicipioPrestacao=nfseLote/atividadeExecutada/localPrestacao/descricaoMunicipio
tipoTributacao=nfseLote/atividadeExecutada/tipoTributacao
tipoRecolhimento=nfseLote/atividadeExecutada/tipoRecolhimento
Aliquota=nfseLote/atividadeExecutada/aliquota
tipo=nfseLote/deducoes/tipo
percentual=nfseLote/deducoes/percentual
valor=nfseLote/deducoes/valor
descricaoNota=nfseLote/detalhamentoNota/descricaoNota
valotTotalNota=nfseLote/detalhamentoNota/totais/valotTotalNota
valorTotalServico=nfseLote/detalhamentoNota/totais/valorTotalServico
valorTotalDeducao=nfseLote/detalhamentoNota/totais/valorTotalDeducao
valorTotalISS=nfseLote/detalhamentoNota/totais/valorTotalISS
valorReducaoBC=nfseLote/detalhamentoNota/totais/valorReducaoBC
tipoPessoa=nfseLote/deducoes/mapa/itemMapa/tipoPessoa
cpf=nfseLote/deducoes/mapa/itemMapa/cpf
cnpj=nfseLote/deducoes/mapa/itemMapa/cnpj
numeroNota=nfseLote/deducoes/mapa/itemMapa/numeroNota
codigoTipo=nfseLote/deducoes/mapa/itemMapa/codigoTipo
descricaoTipo=nfseLote/deducoes/mapa/itemMapa/descricaoTipo
tipoValor=nfseLote/deducoes/mapa/itemMapa/tipoValor
valorNota=nfseLote/deducoes/mapa/itemMapa/valorNota
valorDecucao=nfseLote/deducoes/mapa/itemMapa/valorDecucao
nItem=nfseLote/deducoes/mapa/itemMapa/@nItem
tributavel=nfseLote/detalhamentoNota/itensServico/item/tributavel
descricao=nfseLote/detalhamentoNota/itensServico/item/descricao
quantidade=nfseLote/detalhamentoNota/itensServico/item/quantidade
valorUnitario=nfseLote/detalhamentoNota/itensServico/item/valorUnitario
valorTotal=nfseLote/detalhamentoNota/itensServico/item/valorTotal
nItem=nfseLote/detalhamentoNota/itensServico/item/@nItem
codigoImposto=nfseLote/detalhamentoNota/impostosFederais/imposto/codigoImposto
descricaoImposto=nfseLote/detalhamentoNota/impostosFederais/imposto/descricaoImposto
aliquota=nfseLote/detalhamentoNota/impostosFederais/imposto/aliquota
valorImposto=nfseLote/detalhamentoNota/impostosFederais/imposto/valorImposto
nItem=nfseLote/detalhamentoNota/impostosFederais/imposto/@nItem

;***************************************************************************************************
;Definições dos Campos: Impressão de NFSe (Impressão Nova)
;***************************************************************************************************
[PrintXml_DadosNFSe]
FILE=MappingImpressaoNFSe.txt

;***************************************************************************************************
;Definições dos Campos: Impressão de RPS (Impressão Nova)
;***************************************************************************************************
[PrintXml_DadosRPS]
FILE=MappingImpressaoRPS.txt

;***************************************************************************************************
;Campos de Configuração da Impressão Nova
;***************************************************************************************************
[PrintXml_Config]
ModoImpressao=String[4]
DiretorioTemplates=String[255]
Titulo=String[80]
BrasaoMunicipio=String[255]
LogotipoEmitente=String[255]
ArquivoMunicipios=String[255]
DebugMode=String[5]
NomeCidade=String[80]
NomePadrao=String[80]
SecretariaResponsavel=String[80]
SubtituloNFSe=String[255]